#######
#.T...#
#P..B.#
#.....#
# BT  #
#######
