#######
# T   #
#P  B #
#     #
# BT  #
#######
