#######
# T   #
#P  B #
#   D #
# BT  #
#######
